  1. The World's - (Simon Pegg, Nick Frost, Martin Freeman)
  2. Enough Said - (James Gandolfini, Julia Louis-Dreyfus, Catherine Keener)
  3. Saving Mr. Banks - (Tom Hanks, Emma Thompson, Annie Rose Buckley)
  4. Drinking Buddies - (Olivia Wilde, Jake Johnson, Anna Kendrick)
  5. The Way, Way Back - (Steve Carell, Toni Collette, Allison Janney)
  6. This Is the End - (James Franco, Jonah Hill, Seth Rogen)
  7. Don Jon - (Joseph Gordon-Levitt, Scarlett Johansson, Julianne Moore)
  8. Anchorman 2: The Legend Continues - ( Will Ferrell, Christina Applegate, Paul Rudd)
  9. We're the Millers - (Jason Sudeikis, Jennifer Aniston, Emma Roberts)
10. Warm Bodies - (Nicholas Hoult, Teresa Palmer, John Malkovich)
  1. Moonrise Kingdom - (Edward Norton, Bill Murray, Bruce Willis)
  2. Silver Linings Playbook - (Bradley Cooper, Jennifer Lawrence, Robert De Niro)
  3. 21 Jump Street - (Jonah Hill, Channing Tatum, Ice Cube)
  4. Men in Black 3 - (Will Smith, Tommy Lee Jones, Josh Brolin)
  5. Ted - (Mark Wahlberg, Mila Kunis, Seth MacFarlane)
  6. The Five-Year Engagement - (Jason Segel, Emily Blunt, Chris Pratt)
  7. The Dictator - (Sacha Baron Cohen, Anna Faris, John C. Reilly)
  8. This Is 40 - (Paul Rudd, Leslie Mann, Maude Apatow)
  9. American Reunion - (Jason Biggs, Alyson Hannigan, Seann William )
10. The Campaign - (Will Ferrell, Zach Galifianakis, Jason Sudeikis)
  1. Crazy, Stupid, Love. - (Steve Carell, Ryan Gosling, Julianne Moore)
  2. Bridesmaids - (Kristen Wiig, Maya Rudolph, Rose Byrne)
  3. Cedar Rapids - (Ed Helms, John C. Reilly, Anne Heche)
  4. Our Idiot Brother - (Paul Rudd, Elizabeth Banks, Zooey Deschanel)
  5. 30 Minutes or Less - (Jesse Eisenberg, Danny McBride, Nick Swardson)
  6. 50/50 - (Joseph Gordon-Levitt, Seth Rogen, Anna Kendrick)
  7. Horrible Bosses - (Jason Bateman, Charlie Day, Jason Sudeikis)
  8. The Guard - (Brendan Gleeson, Don Cheadle, Mark Strong)
  9. The Hangover Part II - (Bradley Cooper, Zach Galifianakis, Ed Helms)
10. Paul - (Simon Pegg, Nick Frost, Seth Rogen)
  1. Kick-Ass - (Aaron Johnson, Nicolas Cage, Chloe Moretz)
  2. Due Date - (Robert Downey Jr., Zach Galifianakis, Michelle Monaghan)
  3. The Other Guys - (Will Ferrell, Mark Wahlberg, Derek Jeter)
  4. Get Him to the Greek - (Jonah Hill, Russell Brand, Elisabeth Moss)
  5. Easy A - (Emma Stone, Amanda Bynes, Penn Badgley)
  6. I Love You, Phillip Morris - (Jim Carrey, Ewan McGregor, Leslie Mann)
  7. Hot Tub Time Machine - (John Cusack, Rob Corddry, Craig Robinson)
  8. Date Night - (Steve Carell, Tina Fey, Mark Wahlberg)
  9. Greenberg - (Ben Stiller, Greta Gerwig, Jennifer Jason Leigh)
10. Dinner for Schmucks - (Steve Carell, Paul Rudd, Stephanie Szostak)
  1. The Hangover - (Bradley Cooper, Zach Galifianakis, Ed Helms, Justin Bartha)
  2. The Boat that Rocked - (Philip Seymour Hoffman, Michael Hadley)
  3. A Serious Man - (Michael Stuhlbarg, Richard Kind, Fred Melamed)
  4. I Love You, Man - (Paul Rudd, Jason Segel, Rashida Jones, Jaime Pressly)
  5. Zombieland - (Woody Harrelson, Jesse Eisenberg, Emma Stone)
  6. In The Loop - (Peter Capaldi, Tom Hollander, James Gandolfini)
  7. Up in the Air - (George Clooney, Jason Bateman, Zach Galifianakis)
  8. It's Complicated - (Meryl Streep, Alec Baldwin, Steve Martin)
  9. Funny People - (Adam Sandler, Seth Rogen, Leslie Mann, Eric Bana)
10. The Informant - (Matt Damon, Scott Bakula, Melanie Lynskey, Joel McHale)
  1. Tropic Thunder - (Ben Stiller, Robert Downey Jr., Jack Black)
  2. Forgetting Sara Marshall - (Kristen Bell, Jason Segel, Mila Kunis)
  3. Be Kind Rewind - (Jack Black, Mos Def, Danny Glover)
  4. Zach and Miri Make a Porno - (Seth Rogen, Elizabeth Banks, Craig Robinson)
  5. Role Models - (Seann William Scott, Paul Rudd, Elizabeth Banks)
  6. Pineapple Express - (Seth Rogen, James Franco, Ed Begley Jr.)
  7. Yes Man - (Jim Carrey, Zooey Deschanel, Bradley Cooper)
  8. Get Smart - (Steve Carell, Anne Hathaway, Dwayne Johnson)
  9. Harold and Kumar Escape from Guantanamo Bay - (John Cho, Kal Penn)
10. Step Brothers - (Will Ferrell, John C. Reilly, Mary Steenburgen)
1. The Hobbit: The Desolation of Smaug - (Ian McKellen, Martin Freeman, Richard Armitage)
  2. Iron Man 3 - (Robert Downey Jr., Guy Pearce, Gwyneth Paltrow)
  3. Byzantium - (Saoirse Ronan, Gemma Arterton, Sam Riley)
  4. The Wolverine - (Hugh Jackman, Will Yun Lee, Tao Okamoto)
  5. Thor: The Dark World - (Chris Hemsworth, Natalie Portman, Tom Hiddleston)
  6. Man of Steel - (Henry Cavill, Amy Adams, Michael Shannon)
  7. The Secret Life of Walter Mitty - (Ben Stiller, Kristen Wiig, Jon Daly)
  8. Oz: The Great and Powerful - (James Franco, Michelle Williams, Rachel Weisz)
  9. Jack the Giant Slayer - (Nicholas Hoult, Stanley Tucci, Ewan McGregor)
10. Beautiful Creatures - (Alice Englert, Viola Davis, Emma Thompson)
  1. The Avengers - (Robert Downey Jr., Chris Evans, Scarlett Johansson)
  2. The Amazing Spider-Man - (Andrew Garfield, Emma Stone, Rhys Ifans)
  3. The Hobbit: An Unexpected Journey - (Martin Freeman, Ian McKellen, Richard Armitage)
  4. Snow White and the Huntsman - (Kristen Stewart, Chris Hemsworth, Charlize Theron)
  5. The Odd Life of Timothy Green - (Jennifer Garner, Joel Edgerton, CJ Adams)
  6. The Twilight Saga: Breaking Dawn Part 2 - (Kristen Stewart, Robert Pattinson, Taylor Lautner)
  7. Abraham Lincoln: Vampire Hunter - (Benjamin Walker, Rufus Sewell, Dominic Cooper)
  8. Journey 2: The Mysterious Island - (Josh Hutcherson, Dwayne Johnson, Michael Caine)
  9. Underworld: Awakening - (Kate Beckinsale, Michael Ealy, India Eisley)
10. Wrath of the Titans - (Sam Worthington, Liam Neeson, Rosamund Pike)
  1. Harry Potter and the Deathly Hallows: Part 2 - (Daniel Radcliffe, Emma Watson, Rupert Grint)
  2. Pirates of the Caribbean: On Stranger Tides - (Johnny Depp, Penélope Cruz, Ian McShane)
  3. Midnight in Paris - (Owen Wilson, Rachel McAdams, Kathy Bates)
  4. Thor - (Chris Hemsworth, Anthony Hopkins, Natalie Portman)
  5. Immortals - (Henry Cavill, Mickey Rourke, John Hurt)
  6. Sucker Punch - (Emily Browning, Vanessa Hudgens, Abbie Cornish)
  7. Green Lantern - (Ryan Reynolds, Blake Lively, Peter Sarsgaard)
  8. Season of the Witch - (Nicolas Cage, Ron Perlman, Claire Foy)
  9. Conan the Barbarian - (Jason Momoa, Ron Perlman, Rose McGowan)
10. Beastly - (Alex Pettyfer, Vanessa Hudgens, Mary-Kate Olsen)
  1. Harry Potter and the Deathly Hallows: Part I - (Daniel Radcliffe, Emma Watson, Rupert Grint)
  2. The Chronicles of Narnia: The Voyage of the Dawn Treader - (Ben Barnes, Skandar Keynes)
  3. Alice in Wonderland - (Johnny Depp, Mia Wasikowska, Helena Bonham Carter)
  4. Prince of Persia: The Sands of Time - (Jake Gyllenhaal, Gemma Arterton, Ben Kingsley)
  5. The Sorcerer's Apprentice - (Nicolas Cage, Jay Baruchel, Alfred Molina)
  6. Clash of the Titans - (Sam Worthington, Liam Neeson, Ralph Fiennes)
  7. Percy Jackson & the Olympians: The Lightning Thief - (Logan Lerman, Kevin McKidd, Steve Coogan)
  8. The Troll Hunter - (Otto Jespersen, Hans Morten Hansen, Tomas Alf Larsen)
  9. The Last Airbender - (Noah Ringer, Nicola Peltz, Jackson Rathbone)
10. Nanny McPhee Returns - (Emma Thompson, Maggie Gyllenhaal, Ralph Fiennes)
1. Frozen - (Walt Disney)
  2. Monsters University - (Walt Disney/Pixar)
  3. Despicable Me 2 - (Universal Pictures/Illumination Entertainment)
  4. Cloudy with a Chance of Meatballs 2 - (Columbia Pictures/Sony Pictures Animation)
  5. Epic - (Twentieth Century Fox Animation)
  6. Turbo - (DreamWorks Animation)
  7. The Croods - (DreamWorks Animation)
  8. Free Birds - (Reel FX Creative Studios)
  9. The Smurfs 2 - (Columbia Pictures/Sony Pictures Animation)
10. Approved for Adoption - (2 Minutes Animation/Artémis Productions)
10 Best Animated Movies of 2012
  1. Wreck-It Ralph - (Walt Disney)
  2. Consuming Spirits - (Independent - Chris Sullivan)
  3. Frankenweenie - (Walt Disney/Tim Burton Animation Co.)
  4. ParaNorman - (Laika Entertainment)
  5. The Pirates! Band of Misfits - (Aardman Animations, Sony Pictures Animation)
  6. Brave - (Walt Disney/Pixar)
  7. Rise of the Guardians - (DreamWorks Animation)
  8. Madagascar 3: Europe's Most Wanted - (DreamWorks Animation, Pacific Data Images)
  9. Hotel Transylvania - (Columbia Pictures, Sony Pictures Animation)
10. Ice Age: Continental Drift - (Blue Sky Studios)
10 Best Animated Movies of 2011
  1. The Adventures of Tintin - (Columbia Pictures)
  2. Rango - (Nickelodeon Movies)
  3. Winnie the Pooh - (Walt Disney Studios)
  4. Kung Fu Panda 2 - (DreamWorks)
  5. Rio - (Twentieth Century Fox Animation)
  6. Puss in Boots - (DreamWorks)
  7. Arthur Christmas - (Sony Pictures Animation)
  8. Cars 2 - (Disney/Pixar)
  9. Happy Feet Two - (Village Roadshow Pictures)
10. Gnomeo & Juliet - (Touchstone Pictures)
10 Best Animated Movies of 2010
  1. Toy Story 3 - (Walt Disney Studios)
  2. Tangled - (Walt Disney Studios)
  3. How To Train Your Dragon - (DreamWorks)
  4. The Illusionist - (Django Films)
  5. Despicable Me - (Illumination Entertainment)
  6. The Secret World of Arrietty - (Studio Ghibli)
  7. Megamind - (DreamWorks)
  8. Legend of the Guardians: The Owls of Ga'Hoole - (Warner Bros.)
  9. Shrek Forever After - (DreamWorks)
10. Ultramarines: A Warhammer 40,000 Movie - (Codex Pictures)
  1. Up - (Disney/Pixar) 
  2. Coraline - (Focus Features) 
  3. The Princess and the Frog - (Walt Disney Animation Studios)
  4. Fantastic Mr. Fox - (Twentieth Century-Fox)
  5. Mary and Max - (Melodrama Pictures)
  6. 9 - (Focus Features)
  7. Astro Boy - (Imagi Animation Studios) 
  8. Cloudy with a Chance of Meatballs - (Sony)
  9. Monsters vs. Aliens - (DreamWorks)
10. Ice Age: Dawn of the Dinosaurs - (Blue Sky Studios))
  1. Wall-E - (Pixar)
  2. Ponyo - (Studio Ghibli)
  3. Waltz with Bashir - (Bridgit Folman Film Gang)
  4. Kung Fu Panda - (DreamWorks)
  5. Azur & Asmar - (Nord-Ouest Productions)
  6. Bolt - (Disney)
  7. Horton Hears a Who! - (Blue Sky Studios)
  8. Madagascar: Escape 2 Africa - (DreamWorks)
  9. The Tale of Despereaux - (Universal)
10. Igor - (Exodus Film Group)
1. Mario Bava (Black Sunday)
  2. George A. Romero (Night of the Living Dead)
  3. Terence Fisher (Horror of Dracula)
  4. Dario Argento (Suspiria)
  5. John Carpenter (Halloween)
  6. Wes Craven (A Nightmare on Elm Street)
  7. David Cronenberg (The Fly)
  8. James Whale (Frankenstein)
  9. Alfred Hitchcock (Psycho)
10. Tobe Hooper (The Texas Chain Saw Massacre)
11. Roman Polanski (Rosemary's Baby)
12. William Castle (13 Ghosts)
13. Sam Raimi (The Evil Dead)
14. Tod Browning (Freaks)
15. Lucio Fulci (Zombi)
  1. The Conjuring - (James Wan) (Patrick Wilson, Vera Farmiga, Ron Livingston)
  2. We Are What We Are - (Jim Mickle) (Bill Sage, Ambyr Childers, Julia Garner)
  3. You're Next - (Adam Wingard) (Sharni Vinson, Joe Swanberg, AJ Bowen)
  4. Dark Touch - (Marina de Van) (Missy Keating, Marcella Plunkett, Padraic Delaney)
  5. World War Z - (Marc Forster) (Brad Pitt, Mireille Enos, Daniella Kertesz)
  6. Stoker - (Chan-wook Park) (Mia Wasikowska, Nicole Kidman, Matthew Goode)
  7. Jug Face - (Chad Crawford Kinkle) (Sean Bridgers, Lauren Ashley Carter, Kaitlin Cullum)
  8. Evil Dead - (Fede Alvarez) (Jane Levy, Shiloh Fernandez, Jessica Lucas)
  9. MAMA - (Andrés Muschietti) (Jessica Chastain, Nikolaj Coster-Waldau, Megan Charpentier)
10. 100 Bloody Acres - (Cameron Cairnes , Colin Cairnes) (Damon Herriman, Anna McGahan)
  1. The Cabin in the Woods - (Drew Goddard) (Kristen Connolly, Chris Hemsworth)
  2. Sinister - (Scott Derrickson) (Ethan Hawke, Juliet Rylance)
  3. The Bay - (Barry Levinson) (Kristen Connolly, Jane McNeill)
  4. The Woman in Black - (James Watkins) (Daniel Radcliffe, Janet McTeer)
  5. The Collection - (Marcus Dunstan) (Josh Stewart, Emma Fitzpatrick)
  7. The Possession - (Ole Bornedal) (Natasha Calis, Jeffrey Dean Morgan)
  8. [Rec]3 Génesis - (Paco Plaza) (Leticia Dolera, Diego Martín)
  9. Paranormal Activity 4 - (Henry Joost, Ariel Schulman) (Katie Featherston, Kathryn Newton)
10. Chernobyl Diaries - (Bradley Parker) (Jesse McCartney, Jonathan Sadowski)
  1. Paranormal Activity - (Oren Peli) (Katie Featherston, Micah Sloat)
  2. Antichrist - (Lars von Trier) (Willem Dafoe, Charlotte Gainsbourg)
  3. Drag Me To Hell - (Sam Raimi) (Alison Lohman, Justin Long)
  4. Zombieland - (Ruben Fleischer) (Woody Harrelson, Jesse Eisenberg)
  5. Pontypool - (Bruce McDonald) (Stephen McHattie, Lisa Houle)
  6. The House of the Devil - (Ti West) (Jocelin Donahue, Tom Noonan)
  7. Orphan - (Jaume Collet-Serra) (Vera Farmiga, Peter Sarsgaard)
  8. Dead Snow (Tommy Wirkola) - (Vegar Hoel, Stig Frode Henriksen)
  9. Saw VI (Kevin Greutert) - (Tobin Bell, Costas Mandylor)
10. Grace - (Paul Solet) (Jordan Ladd, Stephen Park)
 1. The Act of Killing - (Former Indonesian death squad leaders reenact their real-life mass-killings)
  2. Stories We Tell - (Contradictory answers to family questions)
  3. These Birds Walk - (A poor runaway boy and a reluctant ambulance driver in Karachi)
  4. The Gatekeepers - (Interviews with all surviving former heads of Shin Bet)
  5. Let The Fire Burn - (Sixty-one homes destroyed by Philadelphia police in 1985)
  6. Blackfish - (Consequences of killer whales in captivity)
  7. The Square - (Egypts Tahrir square in the days leading up to the fall of Mubarak)
  8. 20 Feet From Stardom - (Backup singers in the pop music world)
  9. Call Me Kuchu - (Homosexuality punishable by death in Uganda)
10. Sound City - (David Grohl brings life back to the fabled California recording studio)
  Top 10 Documentary Films of 2012
  1. How to Survive a Plague - (Two coalitions improve the plight of AIDS patients)
  2. The Waiting Room - (Public hospital careing for a community of largely uninsured patients)
  3. West of Memphis - (Catastrophic failure of justice in Arkansas)
  4. The House I Live In - (America's criminal justice system, and implications of U.S. drug policy)
  5. The Central Park Five - (Rape in Central Park and those wrongly accused)
  6. Brooklyn Castle - (Struggling junior high school's champion chess team)
  7. Chasing Ice - (Climate change and melting glaciers documented)
  8. The Flat - (A documentarian learns of his immigrant grandparents difficult past)
  9. Hitler's Children - (The lives of the descendants of the top Nazi officials)
10. The Revisionaries - (A re-write of evolution and American history in textbooks)
  Top 10 Documentary Films of 2010
  1. Restrepo - (One platoon in one valley for one year in Afghanistan)
  2. Inside Job - (A closer look at what brought about the financial meltdown)
  3. Waste Land - (What happens in the world's largest trash city)
  4. Exit through the Gift Shop - (The world's most infamous graffiti artists at work) 
  5. Gasland - (Hydraulic drilling process called "fracking")
  6. Enemies of the People - (The Killing Fields of Cambodia)
  7. The Tillman Story - (Pat Tillman. Life, death, coverup)
  8. Waiting for 'Superman' - (The broken education system)
  9. Precious Life - (Israeli pediatrician and a Palestinian mother)
10. The Elephant in the Living Room - (Dangerous animals as household pets)
  Top 10 Documentary Films of 2009
  1. The Cove - (Louie Psihoyos) (Dolphin abuse in a cove near Taiji, Japan)
  2. Puskás Hungary - (Tamás Almási) (Hungarian football hero of the 1950s)
  3. Crude - (Joe Berlinger) (Ecuadorans against Chevron for contamination of the Amazon)
  4. My Neighbor, My Killer - (Anne Aghion) (The people of Rwanda attempt to reconcile)
  5. Iron Maiden: Flight 666 - (Sam Dunn, Scot McFadyen) (Iron Maiden's 2008 world tour)
  6. Home - (Yann Arthus-Bertrand) (Aerial footage of Earth's problems)
  7. Food, Inc. - (Robert Kenner) (Inside America's corporate controlled food industry)
  8. Anvil - The Story of Anvil - (Sacha Gervasi) (Canadian metal band Anvil)
  9. Unmistaken Child - (Nati Baratz) (A Tibetan monk's search for the reincarnation of his teacher)
10. Capitalism: A Love Story - (Michael Moore) (Corporate dominance on our everyday lives)
